+---+---+---+---+---+---+---+---+
| A                           F |
+   +---+---+---+---+---+---+   +
|   |     C                     |
+   +   +---+---+---+---+---+---+
|                               |
+---+---+   +---+   +---+   +---+
| B         | D     |         G |
+   +---+---+---+---+   +---+---+
|                 E             |
+---+---+---+---+---+---+---+---+
